10
############
#K.........#
#..........#
#..........#
#....Z.....#
#..........#
#..........#
#..........#
#.........P#
############